acies - войско, боевой порядок
administro - осуществлять, выполнять
adventus - приход
aequitas - справедливость
agger - насыпь, вал
actum - делать
alius - другой
amo - любить
anceps - двусторонний
animus - дух
annus - год
aptus - зависимый, упорядоченный, выгодный
arcesso - призывать, приглашать
argumentum - доказательство
aveo - быть здоровым, радоваться
bellum gerere - вести войну
bellum - война
bonum - добро, добродетель, талант, польза
capio - брать, взять
caput - голова
caveo - остерегаться
celeritas - скорость
circulus - круг
cito - быстро
colloco - ставить, расставлять, располагать
committo - начинать, сводить вместе
communis - общий
converto - поворачивать, обращать, превращать
convincium - крик, ссора, брань
copiae - военные силы
decurro - сбегать, сходить вниз
defendo - защищать
definio - определять
delecto - радоваться, захватывать
demonsrto - доказывать, доказывать
describo - описывать, описывать
desum - недоставать, не принимать участия
detraho - вытягивать, разрушать
devenio - приходить, прибывать
disturbo - разрушать, нарушать
diu - долго
diuturnus - длительный, затяжной
dono - дарить
duo - два
egregius - выдающийся
eligo - искоренять, выбирать
eques - всадник
equus - лошадь
etsi - хоть
excito - возбуждать, побуждать, поощрять
expecto - ожидать, ждать
explico - раскрывать
exprimo - выжимать, переводить, четко выражать
fides - вера, доверие, честность, уверенность
flebilis - плачевный, жалостливый
fortis - храбрый
galea - шлем
gero- вести
gestus - жест, позиция
hostis - враг
iam - уже
illuminoe - освещать, делать ярким, украшать
imperator - полководец, обладатель
imperium - приказ
impetum facere - нападать
impetus - набег, натиск
incredibile dictum est - невероятно сказать
induo - одевать
inservio - служить
inspicio - смотреть, рассматривать
instruo - расставлять, оснащать, вооружать
interpretor - толковать, объяснять
invenio - создавать, выдумывать
irrumpo - врываться, вторгаться
legio - легион
machina - машина
malum - беда, зло, несчастье
medius - промежуточный, посредственный
memini - помнить, вспоминать
minimus - наименьший
misericordia - милосердие, сострадание, жалость
mitto - посылать
moneo - напоминать, убеждать
morior - умирать, погибать
mortis - смерть
moveo - умилять
nescio - не знать
nobilis - славный, натный
numero - считать
nummus - деньги, монета
obsidio - осада
obtrunco - рубить, убивать
occupo - захватывать, подчинять
opportunus - удобный, выгодный, пригодный
oppugno - атаковать, нападать
opus - усилие, напряжение
oratio - речь
parco - беречь, жалеть
paro - готовить, заключать
partis - часть
paulo - несколько, немного, едва-едва
pax - мир, покой
pecco - грешить
per se - сам по себе
periculum - опасность
peto - стараться, стремиться, добиваться, просить
pondero - взвешивать
pono - класть, бросать, опускать
postremo - наконец
praedor - грабить
procedo - выходить, выступать, доходить
procurro - выбегать вперед, спешить
proelium committere - начинать битву
proelium - битва
propinquitas - близость
propter - через
propulso - отбивать
prudentia - рассудительность, мудрость
pugno - драться
pulvis - пыль, песок
quasi - как будто, подобно
respondeo - отвечать
revoco - отозвать обратно, отказывать
scutum - щит
sedo - сдерживать, успокаивать, улаживать
sententia - мысль, изречение, взгляд
serus - поздний, запоздалый
signum - знак, сигнал
sileoe - молчать
subito - внезапно
subraucus - хрипловатый, глуховатый
tardatus - замедленный, задержанный
tegimentum - одежда, обшивка, навес
tempestas - время, период
tempus - время
tuba - труба
turbo - беспокоить, волновать
unus - один
utor - пользоваться
verba ponere - высказываться
verbum - слово
versor - пребывать, находиться
vexillum - знамя, флаг
vexillum proponere - поднять сигнальный флаг
vitium - недостаток, изъян, ошибка
vox - голос
